5;5
0;0
- - - - -
- - - - -
- - x x -
- x x x -
- - - - -