8;8
1;1
x x x x x x x x
x - - - - - - x
x - - - x - - x
x - x x x - - x
x - - x x x - x
x - - x - - - x
x - - - - - - x
x x x x x x x x
