9;9
0;3
- - - - - - - - -
- x x x x x x x -
- x - - - - - - -
- x - - - - - - -
- x x x x x x x -
- x - - - - - - -
- x - - - - - - -
- x x x x x x x -
- - - - - - - - -